###########
#p        #
#         #
#         #
#   EEEE  #
# roIb<=b #
#   QQQQ  #
#         #
#         #
#         #
###########
