#########
#*     *#
# ##### #
# #* *# #
# # # # #
#* *#X#P#
#########

  IS
   LA
    KW
     JD
  mixup
