###########
#p        #
#         #
#         #
#   bbbb  #
# roIb<=b #
#   bbbb  #
#         #
#         #
#         #
###########
