###########
#P       *#
#         #
#         #
#   EWTD  #
# ROIB<=B #
#   QSTA  #
#         #
#         #
#*       X#
###########
