###########
#p       *#
#         #
#         #
#   EEEE  #
# roIb<=b #
#   QQQQ  #
#         #
#         #
#*       X#
###########
