#######
#     #
# r y #
#  p  #
# b o #
#     #
#######
