###########
#P       *#
#         #
#         #
#   ETQ   #
# ROIB<=B #
#   QTE   #
#         #
#         #
#*       X#
###########
