#######
#     #
# r y #
# Ip  #
# b o #
#     #
#######
