hello world
###########
#P       *#
#         #
#   # #   #
#   # #   #
#   # #   #
# #     # #
#  #####  #
#         #
#*       X#
###########
IW LD KS JA
